0,0,0,0,0,0,0,0,0,0,0,0,2,0,0,0,0,0,0,0,0,0,0,0,0
13,1,1,1,1,1,1,1,1,1,1,1,3,1,1,1,1,1,1,1,4,0,0,0,0
0,0,0,0,0,0,0,0,0,0,0,0,2,0,0,0,0,0,0,0,2,0,0,0,0
0,0,0,0,0,0,0,0,0,0,0,0,2,0,0,0,0,0,0,0,2,0,0,0,0
0,0,0,0,0,0,0,0,0,0,0,0,2,0,0,0,0,0,0,0,2,0,0,0,0
13,1,1,1,1,1,1,1,4,0,0,0,2,0,0,0,2,0,0,0,2,0,0,0,0
0,0,0,0,0,0,0,0,2,0,0,0,2,0,0,0,2,0,0,0,2,0,0,0,0
0,0,5,1,1,1,1,1,7,0,0,0,2,0,0,0,2,0,0,0,15,13,1,4,0
0,0,2,0,0,0,0,0,0,0,0,0,2,0,0,0,2,0,0,0,0,0,0,2,0
0,0,2,0,0,0,0,0,0,0,0,0,2,0,0,0,2,0,0,0,0,0,0,2,0
0,0,2,0,0,0,0,0,0,0,0,0,2,0,0,0,2,0,0,0,0,0,0,2,0
0,0,2,0,0,0,5,1,1,1,1,1,11,0,0,0,9,1,1,1,0,0,0,2,0
0,0,2,0,0,0,2,0,0,0,0,0,17,0,0,0,2,0,0,0,0,0,0,2,0
0,0,2,0,0,0,2,0,0,0,0,0,17,0,0,0,2,0,0,0,0,0,0,2,0
0,0,2,0,0,0,2,0,0,0,0,0,17,0,0,0,2,0,0,0,0,0,0,2,0
0,0,2,0,0,0,0,0,0,0,5,1,10,1,1,12,2,0,0,0,5,1,1,10,1
0,0,2,0,0,0,0,0,0,0,2,0,0,0,0,0,2,0,0,0,2,0,0,0,0
0,0,2,0,0,0,0,0,0,0,2,0,0,0,0,0,2,0,0,0,2,0,0,0,0
0,0,6,1,1,1,1,1,1,1,7,0,0,0,0,0,2,0,0,0,2,0,0,0,0
0,0,0,0,0,0,0,0,0,0,0,0,0,0,0,0,2,0,0,0,2,0,0,0,0
0,0,0,0,0,0,0,0,0,0,0,0,0,0,0,0,2,0,0,0,2,0,0,0,0
0,0,0,0,0,0,0,0,0,0,0,0,0,0,0,0,2,0,0,0,2,0,0,0,0
0,0,0,0,0,0,0,0,0,0,0,0,0,0,0,0,2,0,0,0,2,0,0,0,0
0,0,0,0,0,0,0,0,0,0,0,0,0,0,0,0,2,0,0,0,2,0,0,0,0
0,0,0,0,0,0,0,0,0,0,0,0,0,0,0,0,2,0,0,0,2,0,0,0,0
